nama,nominal,Cicilan,Tempo,Pembayaran,Sisa
RONAL RENGO,3000000,250000,12,8,4
BISNAWATY,5000000,208333,24,10,14
HIJRIANTY,1700000,283333,6,3,3
ASFAR,2000000,250000,8,2,6
NURNANINGSIH,1000000,333333,3,1,2
AGUSTINUS,1200000,200000,6,4,2
ALDI LENGKE,2300000,191667,12,6,6
WULANDARY,1600000,177778,9,8,1
DERI YANTI,700000,233333,3,2,1
ISNAWATY,2100000,175000,12,3,9
